E S O O O O E E E E
E E O O O O E E E F
E E O O O O E E E E
E E E E E E E E E E
E E E E E E E E E E
O O O O O O E E O O
O O O O O O E E O O
E E E E E E E E O O
E E E E E E E E O O
E E E E E E E E O O