E E E E E E E E E E O O O O O E E E E E O O O O O O O E E E E
E E E E E E E E E E O O O O O E E E E E E E E E E E E E E E E
E E O O O O E E E E E E E E E E E E E E E E E E E E E E E O O
E E O O O O E E E E E E E E E E E E E E O O E E O O O E E O O
E E E E E E E E E E O O O O O E E E E E O O E E O O O E E E E
O O O E E E O O E E E E O O O E E E E E O O E E O O O E E E E
O O O E E E O O E E O E E O O E E E E E O O E E O O O E E E E
O O O E E E O O E E O O E E O E E E E E O O E E O O O E E E E
O O O E E E O O E E O O 0 E E E O O E E E E E E E E E E E E E
E E E E E E E E E E E E E E E E O O E E E E E E E E E E E E E
E E E E O O E E E O O E E O O E E E E E E E E E O O O E E E E
E E E E O O E E E O O E E O O E O O E E E E E E O O O E E E E
E E E E E E E O E E E E E E E E O O E E E E E E E E E E E E E
E E E E E E E O E E E E E E E E E E O O E E E E E E E E E E E
O O O O E E E O E E E E O O O E E E O O E E E E E E E E E E E
O O O O E E E E E E E E O O O E E E E E E E E E E E E E O O E
O O E E E E E E E E E E O O O E E E O O E E E E E E E E O O E
O O E E O O E O O O O E E E E E O O O O E E E E E E E E O O E
O O E E O O E O E E O E E E E E O O E E E E O O O O E E O O E
O O E E O O E O E E O E E E E E O O E E E E O O O O E E O O E
O O E E E E E O E E O E E E E E O O E E E E E E E E E E O O E
O O E E O O E E E E O E E E E E O O E E E E E E E E E E E E E
O O E E O O E E E O O E E E E E O O E E E E O O O O E E E E E
O O E E O O E E E O O E E E E E E E E E E E O O E E E E E E E
E E E E O O E E E O O E E O O E E E E E E E O O E O E E E E E
E E E E O O E E E E E E E O O E O O E E E E E E E E E E E E E
E E E E E E E E E E E E E O O E O O E E E O O E E E E E O O O
E E E E E E O O O E E E E E E E O O E E E O O E E E E E O O O
E E E E E E O O O E E O O E E E E E E E E E E E E E E E O O O
E E E E E E E E E E E O O E E E E E E E E O O E E E E E E E F
E E E E E E E E E E E O O E E E E E E E E O O E E E E E E E E
